6 0 0 0 0 0 0 7 0 0 0 0 0 0 0 0 0 0 4 0 0 0 0 0 0 0 0 0 0 0 0 7 0 0 0 0 0 0 0 0 0 0 0 0 0 0 0 0 0 0 0
4 8 8 8 8 8 8 8 8 8 8 8 8 8 8 8 8 8 1 4 8 8 8 8 8 8 8 8 8 8 8 8 8 8 8 8 8 8 8 8 5 0 0 5 0 5 0 0 5 0 5
1 0 0 0 0 0 0 0 0 0 0 0 0 0 0 0 0 0 1 1 4 4 0 0 0 7 0 0 0 0 0 0 0 0 0 0 0 0 0 4 4 4 4 4 4 4 4 4 4 4 4
1 0 0 0 0 0 0 0 0 0 0 0 0 0 0 0 0 0 1 1 1 1 4 0 0 0 0 0 6 5 6 0 0 7 0 0 0 0 7 0 1 1 1 1 1 1 1 1 1 1 1
1 6 0 5 0 0 0 0 0 7 0 0 0 0 0 0 0 5 1 1 1 1 1 0 0 0 0 0 4 4 4 0 0 0 0 0 0 0 0 0 0 1 1 1 1 1 1 1 1 1 1
1 4 4 4 0 0 0 0 0 0 0 0 0 0 0 0 4 4 1 1 0 0 0 0 7 0 0 0 1 1 1 0 0 0 0 7 0 0 0 0 0 0 1 1 1 1 1 1 1 1 1
1 1 1 1 4 0 0 0 0 0 0 0 0 6 4 4 1 0 0 0 0 0 0 0 0 0 0 0 1 1 1 0 0 0 0 0 0 0 0 0 0 0 1 1 1 0 6 0 1 1 1
1 0 0 0 0 0 0 0 0 0 0 0 4 4 1 1 0 0 6 5 0 0 0 0 0 6 0 0 0 0 0 0 0 0 0 0 5 0 0 0 0 0 1 1 1 0 4 0 1 1 1
1 0 0 7 0 0 0 0 0 6 4 0 0 0 0 1 0 4 4 4 4 4 0 0 0 4 4 0 0 0 0 0 0 0 0 4 4 4 0 0 0 0 1 1 1 0 1 0 1 1 1
1 0 0 0 0 0 0 0 4 4 1 0 0 0 7 0 0 0 1 1 1 0 0 0 0 0 0 0 0 0 0 0 0 0 4 1 1 1 4 0 0 0 1 1 1 0 1 0 1 1 1
1 0 5 0 0 0 0 0 1 1 1 0 0 0 0 0 0 0 0 1 0 0 0 0 0 0 6 0 0 5 0 0 6 4 1 1 1 1 1 4 0 0 1 1 0 0 1 0 0 0 1
1 4 4 0 0 0 0 0 1 1 0 0 0 0 0 0 0 0 0 1 4 4 0 0 0 4 4 4 4 4 4 4 4 1 0 0 0 0 0 6 0 0 1 0 0 0 1 0 4 0 1
1 0 0 0 0 0 0 4 1 1 0 0 0 0 0 0 0 0 0 1 1 1 0 0 0 0 0 0 0 0 0 0 0 0 0 4 4 4 4 4 0 0 1 0 0 0 1 0 1 0 1
1 10 4 0 0 6 0 1 1 1 2 0 5 6 3 6 6 0 2 1 1 1 4 0 0 0 0 0 0 0 4 4 4 4 9 1 1 1 1 1 0 0 0 0 6 2 1 6 1 0 1
1 2 1 4 4 4 4 1 1 1 4 4 4 4 1 4 4 4 4 1 1 1 1 4 4 4 4 4 4 4 1 1 1 1 9 1 1 1 1 1 4 4 4 4 4 4 1 4 1 0 1
1 0 0 0 0 0 0 0 0 0 0 0 0 0 0 0 0 0 0 0 0 0 0 0 0 0 0 0 0 0 0 0 0 0 0 0 0 0 0 0 0 0 0 0 0 0 0 0 0 0 1
1 0 0 0 0 0 0 0 0 0 0 0 0 0 0 0 0 0 0 0 0 0 0 0 0 0 0 0 0 0 0 0 0 0 0 0 0 0 0 0 0 0 0 0 0 0 0 0 0 0 1
1 0 0 0 0 0 0 0 0 0 0 0 0 0 0 0 0 0 0 0 0 0 0 0 0 0 0 0 0 0 0 0 0 0 0 0 0 0 0 0 0 0 0 0 0 0 0 0 0 0 1
1 0 0 0 0 0 0 0 0 0 0 0 0 0 0 0 0 0 0 0 0 0 0 0 0 0 0 0 0 0 0 0 0 0 0 0 0 0 0 0 0 0 0 0 0 0 0 0 0 0 1
1 0 0 0 0 0 0 0 0 0 0 0 0 0 0 0 0 0 0 0 0 0 0 0 0 0 0 0 0 0 0 0 0 0 0 0 0 0 0 0 0 0 0 0 0 0 0 0 0 0 1
1 2 0 0 0 0 0 0 0 0 0 0 0 0 0 0 0 0 0 0 0 0 0 0 0 0 0 0 0 0 0 0 0 0 0 0 0 0 0 0 0 0 0 0 0 0 0 0 0 0 1
1 0 0 0 0 0 0 0 0 0 0 0 0 0 0 0 0 0 0 0 0 0 0 0 0 0 0 0 0 0 0 0 0 0 0 0 0 0 0 0 0 0 0 0 0 0 0 0 0 0 1
1 0 0 0 0 0 0 0 0 0 0 0 0 0 0 0 0 0 0 0 0 0 0 0 0 0 0 0 0 0 0 0 0 0 0 0 0 0 0 0 0 0 0 0 0 0 0 0 0 0 1
1 0 0 0 0 0 0 0 0 0 0 0 0 0 0 0 0 0 0 0 0 0 0 0 0 0 0 0 0 0 0 0 0 0 0 0 0 0 0 0 0 0 0 0 0 0 0 0 0 0 1
1 0 0 0 0 0 0 0 0 0 0 0 0 0 0 0 0 0 0 0 0 0 0 0 0 0 0 0 0 0 0 0 0 0 0 0 0 0 0 0 0 0 0 0 0 0 0 0 0 0 1
1 0 0 0 0 0 0 0 0 0 0 0 8 0 0 0 0 0 0 0 0 0 0 0 8 0 0 0 0 0 0 0 0 0 0 0 8 0 0 0 0 0 0 0 0 0 0 0 0 0 1
1 2 3 3 3 3 3 3 3 3 3 3 3 2 3 3 3 3 3 3 3 3 3 3 3 2 3 3 3 3 3 3 3 3 3 3 3 2 3 3 3 3 3 3 3 3 3 3 3 2 1
1 4 1 1 1 1 1 1 1 1 1 1 1 4 1 1 1 1 1 1 1 1 1 1 1 4 1 1 1 1 1 1 1 1 1 1 1 4 1 1 1 1 1 1 1 1 1 1 1 4 1