5 0 0 0 0 0 8 0 0 0 5
4 0 0 8 0 0 0 0 0 0 4
4 0 0 0 0 0 0 0 0 0 4
4 0 0 0 0 0 0 8 0 0 4
4 8 0 0 0 8 0 0 0 0 4
4 0 8 0 0 0 0 8 0 0 4
4 0 0 0 0 0 0 0 0 0 4
4 0 0 0 0 0 0 0 0 0 4
4 0 6 0 0 0 6 0 0 0 4
4 5 5 5 0 5 5 5 5 0 4
4 0 0 0 0 0 0 0 4 0 4
4 0 0 0 0 0 0 0 4 0 4
4 0 0 0 0 0 0 0 4 0 4
4 7 7 7 2 7 7 7 4 3 4
4 5 5 5 5 5 5 5 4 4 4
4 4 4 4 4 4 4 4 4 4 4